4
640,96
-
656,304,656,398,656,494,656,588
-
-
DDDDDDDDDDDDDDDDDDDDDDD
D000000000000000000000D
D000000000000000000000D
D00DDDDDDDDDDDDDDDDDDDD
D000000000000000000000D
D000000000000000000000D
D00DDDDDDDDDDDDDDDDDDDD
D000000000000000000000D
D000000000000000000000D
D00DDDDDDDDDDDDDDDDDDDD
D000000000000000000000D
D000000000000000000000D
D00DDDDDDDDDDDDDDDDDDDD
D000000000000000000000D
D000000000000000000000D
D00DDDDDDDDDDDDDDDDDDDD
D000000000000000000000D
D000000000000000000000D
D00DDDDDDDDDDDDDDDDDDDD
D000000000000000000000D
D000000000000000000000D
DDDDDDDDDDDDDDDDDDDDDDD
