11
32,672
-
-
-
260,280
KKKKKKKKKKKKKKKKKKKKKKK
KKKKK000KKKKKKK000KKKKK
KKKK00000KKKKK00000KKKK
KKK0000000KKK0000000KKK
KK000000000K000000000KK
K000000000000000000000K
K000000000000000000000K
K000000000000000000000K
K000000000000000000000K
KKK00000000000000000KKK
K000000000000000000000K
K000000000000000000000K
KKK00000000000000000KKK
K000000000000000000000K
K000000000000000000000K
KKK00000000000000000KKK
K000000000000000000000K
K000000000000000000000K
KKK00000000000000000KKK
K000000000000000000000K
K000000000000000000000K
KKKKKKKKKKKKKKKKKKKKKKK
