3
32, 672
338,112,338,208
490,588,167,588
-
-
CCCCCCCCCCCCCCCCCCCCCCC
C000000000000000000000C
C000000000000000000000C
C00CCCCCCCCCCCCCCCCC00C
C000000000000000000000C
C000000000000000000000C
C000CCCCCCCCCCCCCCC000C
C000000000000000000000C
C000000000000000000000C
C000CCC000000000CCC000C
C000C0000000000000C000C
C000C0000000000000C000C
C000CCC000000000CCC000C
C000C0000000000000C000C
C000C0000000000000C000C
C000CCCCCCCCCCCCCCC000C
C000000000000000000000C
C000000000000000000000C
C000CCCCCCCCCCCCCCC000C
C000000000000000000000C
C000000000000000000000C
CCCCCCCCCCCCCCCCCCCCCCC

