12
32, 672
140,116,240,116,350,116,460,116,560,116,140,208,240,208,350,208,460,208,560,208,140,304,240,304,350,304,460,304,560,304,140,398,240,398,350,398,460,398,560,398,140,494,240,494,350,494,460,494,560,494,140,588,240,588,350,588,460,588,560,588,140,682,240,682,350,682,460,682,560,682
-
-
-
LLLLLLLLLLLLLLLLLLLLLLL
L000000000000000000000L
L000000000000000000000L
L00LLLLLLLLLLLLLLLLL00L
L000000000000000000000L
L000000000000000000000L
L00LLLLLLLLLLLLLLLLL00L
L000000000000000000000L
L000000000000000000000L
L00LLLLLLLLLLLLLLLLL00L
L000000000000000000000L
L000000000000000000000L
L00LLLLLLLLLLLLLLLLL00L
L000000000000000000000L
L000000000000000000000L
L00LLLLLLLLLLLLLLLLL00L
L000000000000000000000L
L000000000000000000000L
L00LLLLLLLLLLLLLLLLL00L
L000000000000000000000L
L000000000000000000000L
LLLLLLLLLLLLLLLLLLLLLLL

