6
32, 672
-
260,304,430,398
165,112,527,112
-
FFFFFFFFFFFFFFFFFFFFFFF
F000000000000000000000F
F000000000000000000000F
F00FFFFFFFFFFFFFFFFF00F
F000000000000000000000F
F000000000000000000000F
F0000000FFFFFFF0000000F
F000000000000000000000F
F000000000000000000000F
F0000000FFFFFFF0000000F
F000000000000000000000F
F000000000000000000000F
F0000000FFFFFFF0000000F
F000000000000000000000F
F000000000000000000000F
F0000000FFFFFFF0000000F
F000000000000000000000F
F000000000000000000000F
F00FFFFFFFFFFFFFFFFFF0F
F000000000000000000000F
F000000000000000000000F
FFFFFFFFFFFFFFFFFFFFFFF
