8
334,384
566,304,120,304
566,208,120,494
116,208,574,494
-
HHHHHHHHHHHHHHHHHHHHHHH
H000000000000000000000H
H000000000000000000000H
H00HHH000HHHHH000HHH00H
H000000000000000000000H
H000000000000000000000H
H00HHH000HHHHH000HHH00H
H000000000000000000000H
H000000000000000000000H
H00HHH000HHHHH000HHH00H
H000000000000000000000H
H000000000000000000000H
H00HHH000HHHHH000HHH00H
H000000000000000000000H
H000000000000000000000H
H00HHH000HHHHH000HHH00H
H000000000000000000000H
H000000000000000000000H
H00HHH000HHHHH000HHH00H
H000000000000000000000H
H000000000000000000000H
HHHHHHHHHHHHHHHHHHHHHHH


