7
336,96
656,304,32,398,656,494,32,588
120,112,570,112
-
-
GGGGGGGGGGGGGGGGGGGGGGG
G000000000000000000000G
G000000000000000000000G
G00GGG000GGGGG000GGG00G
G000000000000000000000G
G000000000000000000000G
GGGGGGGGGGG000000000GGG
G000000000000000000000G
G000000000000000000000G
GGG000000000GGGGGGGGGGG
G000000000000000000000G
G000000000000000000000G
GGGGGGGGGGG000000000GGG
G000000000000000000000G
G000000000000000000000G
GGG000000000GGGGGGGGGGG
G000000000000000000000G
G000000000000000000000G
GGGGGGGGGGG000000000GGG
G000000000000000000000G
G000000000000000000000G
GGGGGGGGGGGGGGGGGGGGGGG
