5
336,672
-
-
432,527,257,470,431,344,255,234,420,194
-
EEEEEEEEEEEEEEEEEEEEEEE
E000000000000000000000E
E000000000000000000000E
E00EEEEEEEEEEEEEEEEE00E
E000000EEEEEEEEE000000E
E000000EEEEEEEEE000000E
EEE0000EEEEEEEEE0000EEE
E000000EEEEEEEEE000000E
E000000EEEEEEEEE000000E
EEE0000EEEEEEEEE0000EEE
E000000EEEEEEEEE000000E
E000000EEEEEEEEE000000E
EEE0000EEEEEEEEE0000EEE
E000000EEEEEEEEE000000E
E000000EEEEEEEEE000000E
EEE0000EEEEEEEEE0000EEE
E000000EEEEEEEEE000000E
E000000EEEEEEEEE000000E
EEE00000000000000000EEE
E000000000000000000000E
E000000000000000000000E
EEEEEEEEEEEEEEEEEEEEEEE
