10
32, 672
32,208,656,208,32,588,656,588
32,304,32,398,32,494,656,304,656,398,656,494,
158,112,230,112,350,112,470,112,540,112
-
JJJJJJJJJJJJJJJJJJJJJJJ
J000000000000000000000J
J000000000000000000000J
J00JJJJJJJJJJJJJJJJJ00J
J000000000000000000000J
J000000000000000000000J
JJJJJ0000000000000JJJJJ
J000000000000000000000J
J000000000000000000000J
JJJJJ0000000000000JJJJJ
J000000000000000000000J
J000000000000000000000J
JJJJJ0000000000000JJJJJ
J000000000000000000000J
J000000000000000000000J
JJJJJ0000000000000JJJJJ
J000000000000000000000J
J000000000000000000000J
JJJJJ0000000000000JJJJJ
J000000000000000000000J
J000000000000000000000J
JJJJJJJJJJJJJJJJJJJJJJJ
