1
32, 672
656,494,32,398,656,302
-
-
-
AAAAAAAAAAAAAAAAAAAAAAA
A000000000000000000000A
A000000000000000000000A
A00AAAAAAAAAAAAAAAAAAAA
A000000000000000000000A
A000000000000000000000A
AAAAAAAAAAAAAAA0000000A
A000000000000000000000A
A000000000000000000000A
A000000AAAAAAAAAAAAAAAA
A000000000000000000000A
A000000000000000000000A
AAAAAAAAAAAAAAAA000000A
A000000000000000000000A
A000000000000000000000A
A0000000AAAAAAAAAAAAAAA
A000000000000000000000A
A000000000000000000000A
AAAAAAAAAAAAAAAA000000A
A000000000000000000000A
A000000000000000000000A
AAAAAAAAAAAAAAAAAAAAAAA
