9
32, 672
-
128,112,564,112,128,304,564,304,128,494,564,494
336,304
-
IIIIIIIIIIIIIIIIIIIIIII
I000000000000000000000I
I000000000000000000000I
I00III000IIIII000III00I
I000000000000000000000I
I000000000000000000000I
I00IIIIIIIIIIIIIIIII00I
I000000000000000000000I
I000000000000000000000I
I00III000IIIII000III00I
I000000000000000000000I
I000000000000000000000I
I00IIIIIIIIIIIIIIIII00I
I000000000000000000000I
I000000000000000000000I
I00III000IIIII000III00I
I000000000000000000000I
I000000000000000000000I
I00IIIIIIIIIIIIIIIII00I
I000000000000000000000I
I000000000000000000000I
IIIIIIIIIIIIIIIIIIIIIII
