0
33, 672
-
340,490
-
-
AAAAAAAAAAAAAAAAAAAAAAA
A000000000000000000000A
A000000000000000000000A
A000LLLLLLLLLLLLLLLL00A
A000000000000000000000A
A000000000000000000000A
AJJJJJJJJ0000KKKKKKKKKA
A000000000000000000000A
A000000000000000000000A
AHHHHHHHH0000IIIIIIIIIA
A000000000000000000000A
A000000000000000000000A
AFFFFFFFF0000GGGGGGGGGA
A000000000000000000000A
A000000000000000000000A
ADDDDDDDD0000EEEEEEEEEA
A000000000000000000000A
A000000000000000000000A
ABBBBBBBBB000CCCCCCCCCA
A000000000000000000000A
A000000000000000000000A
AAAAAAAAAAAAAAAAAAAAAAA