2
336,672
32,208,32,398,656,304,656,494
-
-
-
BBBBBBBBBBBBBBBBBBBBBBB
B000000000000000000000B
B000000000000000000000B
BBBBB00BBBBBBBBB00BBBBB
B000000000000000000000B
B000000000000000000000B
BBBBB00BBBBBBBBB00BBBBB
B000000000000000000000B
B000000000000000000000B
BBBBB00BBBBBBBBB00BBBBB
B000000000000000000000B
B000000000000000000000B
BBBBB00BBBBBBBBB00BBBBB
B000000000000000000000B
B000000000000000000000B
BBBBB00BBBBBBBBB00BBBBB
B000000000000000000000B
B000000000000000000000B
BBBBB0000000000000BBBBB
B000000000000000000000B
B000000000000000000000B
BBBBBBBBBBBBBBBBBBBBBBB
